book	<html><head></head><body contenteditable="true"><p>sách&nbsp;</p><br></body></html>
family	<html><head></head><body contenteditable="true"><p><span style="font-family: &quot;&quot;;">gia dinh</span></p><br></body></html>
fast	<html><head></head><body contenteditable="true">nhanh nhanh</body></html>
food	thức ăn
friend	<html><head></head><body contenteditable="true"><h2><span style="color: rgb(153, 0, 0);">bạn</span></h2></body></html>
goodbye	tạm biệt
happy	<html><head></head><body contenteditable="true">hạnh phúc</body></html>
hello	xin chào
hot	nóng
love	<html><head></head><body contenteditable="true">tình yêu</body></html>
no	không
old	già
play	chơi
sad	buồn
school	trường học
small	nhỏ
sorry	xin lỗi
student	học sinh
teacher	giáo viên
thank you	cảm ơn bạn
tired	mệt mỏi
ugly	xấu xí
water	nước
work	công việc
yes	có
young	trẻ
